наименование (город / страна)	житель (он, м.р.)	жительница (она, ж.р.)	жители (они, мн.ч.)
Абака́н	абака́нец	абака́нка	абака́нцы
Абу-Да́би	абуда́бец	абуда́бка	абуда́бцы
Абу́джа	абу́джец	абу́джайка	абу́джцы
Абха́зия	абха́зец	абха́зка	абха́зцы
Австра́лия	австрали́ец	австрали́йка	австрали́йцы
А́встрия	австри́ец	австри́йка	австри́йцы
Адди́с-Абе́ба	аддисабе́бец	аддисабе́бка	аддисабе́бцы
Адыге́я	адыге́ец	адыге́йка	ады́ге
Аза́д-Кашми́р	аза̀дкашми́ровец	аза̀дкашми́ровка	аза̀дкашми́ровцы
Азербайджа́н	азербайджа́нец	азербайджа́нка	азербайджа́нцы
А́зия	азиа́т	азиа́тка	азиа́ты
Айда́хо	айда́ховец	айда́ховка	айда́ховцы
Айо́ва	айо́вец	айова́нка	айо́вцы
А́ккра	а́ккрец	а́ккрка	а́ккрцы
Алаба́ма	алаба́мец	алаба́мка	алаба́мцы
Алба́ния	алба́нец	алба́нка	алба́нцы
Алжи́р	алжи́рец	алжи́рка	алжи́рцы
Алта́й	алта́ец	алта́йка	алта́йцы
Алта́йский край	алта́ец	алта́йка	алта́йцы
Аля́ска	аля́скинец	аля́скинка	аля́скинцы
Аме́рика	америка́нец	америка́нка	америка́нцы
Амма́н	амма́нец	амма́нка	амма́нцы
Амстерда́м	амстерда́мец	амстерда́мка	амстерда́мцы
Аму́рская о́бласть	амурча́нин	амурча́нка	амурча́не
Ана́дырь	ана́дырец	ана́дырка	ана́дырьцы
Анато́лия	анатоли́ец	анатоли́йка	анатоли́йцы
Анго́ла	анго́лец	анго́лка	анго́льцы
Андо́рра	андорра́нец	андорра́нка	андорра́нцы
Андо́рра-ла-Ве́лья	андо́ррец	андо́ррка	андо́ррцы
Анкара́	анка́рец	анка́рка	анка́рцы
Анна́полис 	анна́полисец	анна́полиска	анна́полисцы
Антананари́ву	антананари́вец	антананари́вка	антананари́вцы
Анти́гуа	антигуа́нец	антигуа́нка	антигуа́нцы
Аомы́нь	аомы́нец	аомы́нька	аомы́ньцы
А́пиа	а́пиец	а́пийка	а́пийцы
Ара́бия	араби́ец	араби́ка	араби́йцы
Ара́бская земля	ара́б	ара́бка	ара́бы
Ара́бские Эмира́ты	эмира́товец	эмира́товка	эмира́товцы
Ара́вия	аравитя́нин	аравитя́нка	аравитя́не
Ара́вия	арави́ец	арави́йка	арави́йцы
Аргенти́на	аргенти́нец	аргенти́нка	аргенти́нцы
Аризо́на	аризо́нец	аризо́нка	аризо́нцы
Арканза́с	арканза́сец	арканза́ска	арканза́сцы
Арме́ния	армяни́н	армя́нка	армя́не
Арха́нгельск	арха́нгелец	арха́нгелька	арха́нгельцы
Асмэ́ра	асмэ́рец	асмэ́рка	асмэ́рцы
Астана́	астанча́нец	астанча́нка	астанча́не
Астраха́нская о́бласть	астраха́нец	астраха́нка	астраха́нцы
А́страхань	а́страханец	а́страха́нка	а́страханцы
Астраха́ньщина	астраха́ньщинец	астраха́ньщинка	астраха́ньщинцы
Асунсьо́н	асунсьо́нец	асунсьо́нка	асунсьо́нцы
Атла́нта 	атла́нтец	атла́нтка	атла́нтцы
Афганиста́н	афга́нец	афга́нка	афга́нцы
Афи́ны	афи́нец	афи́нка	афи́нцы
А́фрика	африка́нец	африка́нка	африка́нцы
Ашхаба́д	ашхаба́дец	ашхаба́дка	ашхаба́дцы
Бава́рия	бава́рец	бава́рка	бава́рцы
Бага́мские Острова́	бага́мец	бага́мка	бага́мцы
Багда́д	багда́дец	багда́дка	багда́дцы
Ба́ден-Вю́ртемберг	ба́денвю́ртембергец	ба́денвю́ртембергка	ба́денвю́ртембергцы
Баку́	баки́нец	баки́нка	баки́нцы
Балканы	балка́нец	балка́нка	балка́нцы
Бамако́	бамако́вец	бамако́вка	бамако́вцы
Банги́	банги́ец	банги́йка	банги́йцы
Бангко́к	бангко́кец	бангко́кка	бангко́кцы
Бангладе́ш	бангладе́шец	бангладе́шка	бангладе́шцы
Ба́ндар-Сери́-Бега́ван	бандарсерибегава́нец	бандарсерибегава́нка	бандарсерибегава́нцы
Банжу́л	банжу́лец	банжу́лка	банжу́лцы
Барбадо́с	барбадо́сец	барбадо́ска	барбадо́сцы
Барбу́да	барбуда́нец	барбуда́нка	барбуда́нцы
Барнау́л	барнау́лец	барнау́лка	барнау́льцы
Басте́р	басте́рец	басте́рка	басте́рцы
Ба́тон-Руж 	ба́тонру́жец	ба́тонру́жка	ба́тонру́жцы
Бахре́йн	бахре́йнец	бахре́йнка	бахре́йнцы
Башкортоста́н	башкортоста́нец	башкортоста́нка	башкортоста́нцы
Бейру́т	бейру́тец	бейру́тка	бейру́тцы
Белару́сь	белару́с	белару́ска	белару́сы
Бе́лгород	бе́лгородец	бе́лгородка	бе́лгородцы
Белгоро́дская о́бласть	белгоро́дец	белгоро́дка	белгоро́дцы
Белгоро́дщина	белгоро́дщинец	белгоро́дщинка	белгоро́дщинцы
Белгра́д	белгра́дец	белгра́дка	белгра́дцы
Бели́з	бели́зец	бели́зка	бели́зцы
Белору́ссия	белору́с	белору́ска	белору́сы
Бе́льгия	бельги́ец	бельги́йка	бельги́йцы
Бельмопа́н	бельмопа́нец	бельмопа́нка	бельмопа́нцы
Бени́н	бени́нец	бени́нка	бени́нцы
Берли́н	берли́нец	берли́нка	берли́нцы
Берн	бе́рнец	бе́рнка	бе́рнцы
Бёрнт-Пайн	бёрнтпайнец	бёрнтпайнка	бёрнтпайнцы
Беробиджа́н	беробиджа́нец	беробиджа́нка	беробиджа́нцы
Би́рма	би́рманец	би́рманка	би́рманцы
Биса́у	биса́увец	биса́увка	биса́увцы
Би́смарк 	би́смаркец	би́смаркка	би́смаркцы
Бишке́к	бишке́куц	бишке́кка	бишке́кцы
Благове́щенск	благове́щенец	благове́щенка	благове́щенцы
Богота́	богата́нец	богата́нка	богата́нцы
Бо́йсе 	бо́йсеец	бо́йсейка	бо́йсецы
Болга́рия	болга́рин	болга́рка	болга́ры
Боли́вия	боливи́ец	боливи́йка	боливи́йцы
Бонн	бо́ннец	бо́ннка	бо́ннцы
Бо́сния	босни́ец	босни́йка	босни́йцы
Бо́стон 	бо́стонец	бо́стонка	бо́стонцы
Ботсва́на	ботсва́нец	ботсва́нка	ботсва́нцы
Браззави́ль	браззави́лец	браззави́лька	браззави́льцы
Брази́лиа	брази́льанец	брази́льанка	брази́льанцы
Брази́лия	брази́лец	бразилья́нка	брази́льцы
Бра́нденбург	бра́нденбу́ргец	бра́нденбу́ргка	бра́нденбу́ргцы
Братисла́ва	братисла́вец	братисла́венка	братисла́вцы
Бре́мен	бре́менец	бре́менка	бре́менцы
Бриджта́ун	бриджта́унец	бриджта́унка	бриджта́унцы
Бруне́й	бруне́ец	бруне́йка	бруне́йцы
Брюссе́ль	брюссе́лец	брюсселья́нка	брюссе́льцы
Брянск	брянча́нин	брянча́нка	брянча́не
Бря́нская о́бласть	бря́нщинец	бря́нщинка	бря́нцы
Бря́нщина	бря́нщинец	бря́нщинка	бря́нщицы
Будапе́шт	будапе́штец	будапе́штка	будапе́штцы
Буркина́-Фасо́	буркини́ец	буркини́йка	буркини́йцы
Буру́нди	бурунди́ец	бурунди́йка	бурунди́йцы
Буря́тия	буря́т	буря́тка	буря́ты
Бута́н	бута́нец	бута́нка	бута́нцы
Бухаре́ст	бухаре́стец	бухаре́стка	бузаре́стцы
Буэ́нос-А́йрес	бу́эноса́йресец	бу́эноа́йреска	буэ́носа́йресцы
Ваду́ц	ваду́цец	ваду́цка	ваду́ццы
Вайо́минг	вайо́мингец	вайо́мингка	вайо́мингцы
Валле́тта	валле́ттец	валле́ттанка	валле́ттцы
Вануа́ту	вануа́тец	вануа́тка	вануа́тцы
Варша́ва	варша́вец	варшавя́нка	варша́вцы
Ватика́н	ватика́нец	ватика́нка	ватика́нцы
Вашингто́н	вашингто́нец	вашингто́нка	вашингто́нцы
Вели́кий Но́вгород	но́вгородец	но́вгородка	но́вгородцы
Великобрита́ния	великобрита́нец	великобрита́нка	великобрита́нцы
Ве́ллингто́н	ве́ллингто́нец	ве́ллингто́нка	ве́ллингто́нцы
Ве́на	ве́нец	ве́нка	ве́нцы
Ве́нгрия	венгр	венге́рка	ве́нгры
Венесуэ́ла	венесуэ́лец	венесуэ́лка	венесуэ́льцы
Вермо́нт	вермо́нтец	вермо́нтка	вермо́нтцы
Викто́рия	викториа́нец	викториа́нка	викториа́нцы
Ви́льнюс	ви́льнюсец	ви́льнюска	ви́льнюсцы
Ви́ндхук	ви́ндхукнец	ви́ндхукка	ви́ндхукцы
Вирги́ния	вирги́нец	вирги́нка	вирги́нцы
Ви́сба́ден	висба́денец	висба́денка	висба́денцы
Виско́нсин	виско́нсинец	виско́нсинка	виско́нсинцы
Владивосто́к	владивосто́кец	владивосто́чка	владивосто́кцы
Владивосто́к	владивосто́ковец	владивосто́ковка	владивосто́ковцы
Владикавка́з	владикавка́зец	владикавка́зка	владикавка́зцы
Влади́мир	влади́мирец	владир́ка	влади́мирцы
Влади́мировщина	влади́мировщинец	владир́овщинка	влади́мировщинцы
Влади́мирская о́бласть	влади́мировец	владир́овка	влади́мировцы
Волгогра́д	волгогра́дец	волгогра́дка	волгогра́дцы
Волгогра́дщина	волгогра́дщинец	волгогра́дщинка	волгогра́дщинцы
Во́логда	волого́дец	волого́дка	волого́дцы
Волого́дщина	волого́дщинец	волого́дщинка	волого́дщинцы
Воро́неж	воро́нежец	воро́нежка	воро́нежцы
Воро́нежщина	воро́нежщинец	воро́нежщинка	воро́нежщинцы
Восто́чная Евро́па	восто̀чноевропе́ец	восто̀чноевропе́йка	восто̀чноевропе́йцы
Вьентья́н	вьентья́нец	вьентья́нка	вьентья́нцы
Вьетна́м	вьетна́мец	вьетна́мка	вьетна́мцы
Вэ́ст-А́йленд / Уэ́ст-А́йленд	вэста́йлендец	вэста́йлендка	вэста́йлендцы
Габо́н	габо́нец	габо́нка	габо́нцы
Габоро́не	габоро́нец	габоро́нка	габоро́нцы
Гава́йи	гава́йец	гава́йка	гава́йцы
Гава́на	гава́нец	гава́нка	гава́нцы
Гаи́ти	гаитя́нин	гаитя́нка	гаитя́не
Гайа́на	гайа́нец	гайа́нка	гайа́нцы
Га́мбия	гамби́ец	гамби́йка	гамби́йцы
Га́мбург	га́мбургец	га́мбургка	га́мбургцы
Га́на	га́нец	га́нка	га́нцы
Ганно́вер	гонно́верец	гонно́верка	гонно́верцы
Га́ррисберг 	га́ррисбергец	га́ррисбергка	га́ррисбергцы
Га́тчина	га́тчинец	га́тчинка	га́тчинцы
Гватема́ла	гватема́лец	гватема́лка	гватема́льцы
Гвиа́на	гвиа́нец	гвиа́нка	гвиа́нцы
Гвине́я	гвине́ец	гвине́йка	гвине́йцы
Гвине́я-Биса́у	биса́у-гвине́ец	биса́у-гвине́йка	биса́у-гвине́йцы
ГДР	ГДРовец гэдээ́ровец	ГДРовка гэдээ́ровка	ГДРовцы гэдээ́ровцы
Герма́ния	герма́нец	герма́нка	герма́нцы
Ге́рнси Са́рния	ге́рнсиец са́рни́ец	гернсийка са́рни́йка	ге́рнсийцы са́рни́йцы
Герцегови́на	герцегови́нец	герцегови́нка	герцегови́нцы
Ге́ссен	ге́ссенец	ге́ссенка	ге́ссенцы
Гите́га	гите́гец	гите́гка	гите́гцы
Гондура́с	гондура́сец	гондура́ска	гондура́сцы
Гонко́нг Сянга́н	гонко́нгец сянга́нец	гонко́нгка сянга́нка	гонко́нгцы сянга́нцы
Гонолу́лу 	гонолу́лец	гонолу́леца	гонолу́льцы
Го́рно-Алта́йск	горноалта́ец	горноалта́йка	горноалта́йцы
Грена́да	грена́дец	грена́дка	грена́дцы
Гре́ция	грек	греча́нка	гре́ки
Гро́зный	гро́зненец	гро́зненка	гро́зненцы
Гру́зия	грузи́н	грузи́нка	грузи́ны
Грютви́кен / Кинг-Эдуард-Пойнте	грютви́кенец	грютви́кенка	грютви́кенцы
Дагеста́н	дагеста́нец	дагеста́нка	дагеста́нцы
Дака́р	дака́рец	дака́рка	дака́рцы
Да́кка	да́ккец	да́ккеца	да́ккцы
Дальневосто́чный о́круг	дальневосто́ченец	дальневосто́ченка	дальневосто́ченцы
Дама́ск	дама́скец	дама́скеца	дама́скцы
Да́ния	датча́нин	датча́нка	датча́не
Де-Мойн 	демо́йнец	демо́йненка	демо́йнцы
Делавэ́р	делавэ́рец	делавэ́рка	делавэ́рцы
Де́ли	дели́ец	дели́цка	дели́йцы
Де́нвер 	де́нверец	де́нверка	де́нверцы
Джака́рта	джака́ртец	джака́ртка	джака́ртцы
Джа́мму	джа́ммуец	джа́ммуйка	джа́ммуйцы
Дже́рси	джерси́ец	джерси́йка	джерси́йцы
Дже́фферсон-Си́ти 	дже́фферсонец	дже́фферсонка	дже́фферсонцы
Джибу́ти	джибути́ец	джибути́йка	джибути́йцы
Джо́рджия	джо́рджиец	джо́рджийка	джо́рджийцы
Джорджта́ун	джорджта́унец	джорджта́унка	джорджта́унцы
Джу́ба	джуба́ец	джуба́йка	джуба́йцы
Джу́но 	джу́новец	джу́новка	джу́новцы
Джэ́ксон 	джэ́ксонец	джеэ́ксонка	джэ́ксонцы
Ди́ли	дили́ец	дили́йка	дили́йцы
ДНР	дэнээ́ровец	дэнээ́ровка	дэнээ́ровцы
До́вер 	до́верец	до́верка	до́верцы
Додо́ма	додо́мец	додо́мка	додо́мцы
Домини́ка	доминика́нец	доминиканка	доминиканцы
Доминика́нская Респу́блика	доминика́нец	доминиканка	доминиканцы
Дон	донча́нец	донча́ница	донча́нцы
Доне́цк	донча́нин	донча́нка	донча́не
Доне́цкая Наро́дная Респу́блика	донча́нин	донча́нка	донча́не
До́ха	доха́ец	доха́йка	доха́йцы
Дре́зден	дре́зденец	дре́зденка	дре́зденцы
Ду́блин	ду́блинец	ду́блинка	ду́блинцы
Ду́глас	ду́гласец	ду́гласка	ду́гласцы
Ду́лиш	ду́лишец	ду́лишка	ду́лишцы
Душанбе́	душанби́нец	душанби́нка	душанби́нцы
Дюссельдо́рф	дюссельдо́рфец	дюссельдо́рфка	дюссельдо́рфцы
Евразийский континент Европа и Азия	ерази́ец	еврази́йка	ерази́йцы
Евре́йская автоно́мная о́бласть	евре́й	евре́йка	евре́и
Европейский континент	европе́ец	европе́йка	европе́йцы
Еги́пет	египтя́нин	египтянка	египтяне
Екатеринбу́рг	екатеринбу́ржец	екатеринбу́рженка	екатеринбу́ржцы
Екатеринбу́рг	екатеринбу́ржец	екатеринбу́рженка	екатеринбу́гцы
Ерева́н	ерева́нец	ерева́нка	ерева́нцы
Забайка́льский край	забайка́лец	забайка́лка	забайка́льцы
За́греб	за́гребец	за́гребка	за́гребцы
За́мбия	замби́ец	замби́йка	замби́йцы
За́падная Вирги́ния	западновирги́нец	западновирги́нка	западновирги́нцы
Западноевропе́йская часть контине́нта	за́падноевропе́ец	за́падноевропе́йка	за́падноевропе́йцы
Зимба́бве	зимбабви́ец	зимбабви́йка	зимбабви́йцы
Ива́ново	ива́новец	ива́новка	ива́новцы
Ива́новщина	ива́новщинец	ива́новщинка	ива́новщинцы
Иерусали́м	иерусали́мец	иерусали́мка	иерусали́мцы
Иже́вск	иже́вец	иже́вка	иже́вцы
Изра́иль	израильтя́нин	израильтя́нка	израильтя́не
Иллино́йс	иллино́йсец	иллино́йска	иллино́йсцы
Ингуше́тия / Респу́блика Ингуше́тия	ингу́ш	ингу́шка	ингуши́
Индиа́на	индиа́нец	индиа́нка	индиа́нцы
Индиана́полис 	индиана́полисец	индиана́полиска	индиана́полисцы
И́ндия	инди́ец	индиа́нка	инди́йцы
Индоне́зия	индонези́ец	индонези́йка	индонези́йцы
Иорда́ния	иорда́нец	иорда́нка	иорда́нцы
Ира́к	ира́кец	ира́кша	ира́кцы
Ира́н	ира́нец	ира́нка	ира́нцы
Ирку́тск	ирку́тец	ирку́тка	ирку́тцы
Ирку́тск	иркутча́нец	иркутча́нка	иркутча́нцы
Ирку́тск	иркутча́нец	иркутча́нка	иркутча́не
Ирла́ндия	ирла́ндец	ирла́ндка	ирла́ндцы
Исламаба́д	исламаба́дец	исламаба́дка	исламаба́дцы
Исла́ндия	исла́ндец	исла́ндка	исла́ндцы
Испа́ния	испа́нец	испа́нка	испа́нцы
Ита́лия	италья́нец	италья́нка	италья́нцы
Йе́мен	йе́менец	йе́менка	йе́менцы
Йошка́р-Ола́	йошкароли́нец	йошкароли́нка	йошкароли́нцы
Кабарди́но-Балка́рия	балка́рец	балка́рка	балка́рцы
Кабарди́но-Балка́рия	кабарди́нец	кабарди́нка	кабарди́нцы
Кабарди́но-Балка́рия	кабардинобалка́рец	кабардинобалка́рка	кабардинобалка́рцы
Ка́бо-Ве́рде	кабовердиа́нец	кабовердиа́нка	кабовердиа́нцы
Кабу́л	кабу́лец	кабу́лка	кабу́льцы
Каза́нь	каза́нец	каза́нка	каза́нцы
Казахста́н	казахста́нец	казахста́нка	казахста́нцы
Каи́р	каи́рец	каи́рка	каи́рцы
Кайе́нна	кайе́ннец	кайе́ннка	кайе́ннцы
Калинигра́д	калинингра́дец	калинингра́дка	калинингра́дцы
Кали́нин	кали́нинец	кали́нинка	кали́нинцы
Калинингра́дщина	калинингра́дщинец	калинингра́дщинка	калинингра́дщинцы
Кали́нинщина	кали́нинщинец	кали́нинщинка	кали́нинщинцы
Калифо́рния	калифорни́ец	калифорни́йка	калифорни́йцы
Калмы́кия	калмы́к	калмы́чка	калмы́ки
Калу́га	калу́жец	калужа́нка	калу́жцы
Калу́жщина	калу́жщинец	калу́жщинка	калу́жщинцы
Камбо́джа	камбоджи́ец	камбоджи́йка	камбоджи́йцы
Камеру́н	камеру́нец	камеру́нка	камеру́нцы
Кампа́ла	кампа́лец	кампа́лка	кампа́лцы
Камча́тка	камча́товец	камча́товка	камча́тцы / камча́товцы
Кана́да	кана́дец	кана́дка	кана́дцы
Канбе́рра	канбе́ррец	камбе́ррка	канбе́ррцы
Канза́с	канза́сец	канза́ска	канза́сцы
Караба́х	караба́ховец	караба́ховка	караба́хцы
Карака́с	карака́сец	карака́ска	карака́сцы
Карача́ево-Черке́ссия	карача́евец	карача́евка	карача́евцы
Карача́ево-Черке́ссия	карачаевочерке́с	карачаевочерке́ска	карачаевочерке́сы
Карача́ево-Черке́ссия	черке́с	черке́ска	черке́сы
Каре́лия	каре́л	каре́лка	каре́лы
Ка́рсон-Си́ти 	ка́рсонец	ка́рсонка	ка́рсонцы
Кастри́	кастри́ец	кастри́йка	кастри́йцы
Ка́тар	ка́тарец	ка́тарка	ка́тарцы
Катманду́	катманди́ец	катманди́йка	катманди́йцы
Кашми́р	кашми́рец	кашми́рка	кашми́рцы
Ке́мерово	ке́меровец	ке́меровка	ке́меровцы
Ке́ния	кени́ец	кени́йка	кени́йцы
Кенту́кки	кенту́кковец	кенту́кковка	кенту́кковцы
Кига́ли	кига́лец	кигали́йка	кига́льцы
Ки́ев	киевля́нин	киевля́нка	киевля́не
Ки́линг	ки́лингец	ки́лингка	ки́лингцы
Киль	ки́лец	ки́лька	ки́льцы
Кингста́ун	кингста́унец	кингста́унка	кингста́унцы
Ки́нгстон	ки́нгстонец	ки́нгстонка	ки́нгстонцы
Кинша́са	кинша́сец	кинша́ска	кинша́сцы
Кипр	киприо́т	киприо́тка	киприо́ты
Кирги́зия	кирги́з	кирги́зка	кирги́зы
Киргизста́н	киргизста́нец	киргизста́нка	киргизста́нцы
Кириба́ти	кириба́тец	кириба́тка	кириба́тцы
Ки́ров	ки́ровец	кировча́нка	ки́ровцы
Ки́ровщина	ки́ровщинец	ки́ровщинка	ки́ровщинцы
Кита́й	кита́ец	китая́нка	кита́йцы
Ки́то	ки́тоец	ки́тойка	ки́тойцы
Кишинёв	кишинёвец	кишинёвка	кишинёвцы
КНДР	северокоре́ец	северокорея́нка	северокоре́йцы
Коко́совые острова́	мала́ец	мала́йка	коко́совые мала́йцы
Колора́до	колора́довец	колора́довка	колора́довцы
Колу́мбия	колумби́ец	колумби́йка	колумби́йцы
Колу́мбия 	колумби́ец	колумби́йка	колумби́йцы
Колу́мбус 	колу́мбусец	колу́мбуска	колу́мбусцы
Ко́ми	коми́ч	коми́чка	комичи́
Комо́ры	комо́рец	комо́рка	комо́рцы
Ко́накри́	конакри́ец	конакри́йка	конакри́йцы
Ко́нго	конголе́зец	конголе́зка	конголе́зцы
Ко́нкорд 	ко́нкордец	ко́нкордша	ко́нкордцы
Конне́ктикут	конне́ктикутовец	конне́ктикутовка	конне́ктикутовцы
контине́нт	континента́лец	континента́лка	континента́льцы
Копенга́ген	копенга́генец	копенга́генка	копенга́генцы
Коре́я	коре́ец	корея́нка	коре́йцы
Ко́сово	косова́р	косова́рка	косова́ры
Ко́ста-Ри́ка	костарика́нец	костарика́нка	костарика́нцы
Кострома́	костроми́ч	костроми́чка	костромичи́
Кострома́	костромча́нин	костромча́нка	костромча́не
Кот-д’Ивуа́р	котдивуа́рец	котдивуа́рка	котдивуа́рцы
Кот-д’Ивуа́р	ивуари́ец	ивуари́йка	ивуари́йцы
Красного́рск	красного́рец	красного́рка	красного́рцы
Краснода́р	краснода́рец	краснода́рка	краснода́рцы
Краснода́рщина	краснода́рщинец	краснода́рщинка	краснода́рщинцы
Красноя́рск	красноя́рец	красноя́рка	красноя́рцы
Красноя́рщина	красноя́рщинец	красноя́рщинка	красноя́рщинцы
Крым	крымча́нин	крымча́нка	крымча́не
Куа́ла-Лумпу́р	куа́лалумпу́рец	куа́лалумпу́рка	куа́лалумпу́рцы
Ку́ба	куби́нец	куби́нка	куби́нцы
Куба́нь	куба́нец	куба́нка	куба́нцы
Куве́йт	куве́йтец	куве́йтка	куве́йтцы
Кузба́сс	кузба́ссовец	кузба́ссовка	кузба́ссовцы
Кузба́сс	кузба́ссец	кузба́сска	кузба́ссцы
Курга́н	курга́нец	курга́нка	курга́нцы
Курга́нщина	курга́нщинец	курга́нщинка	курга́нщинцы
Курск	курча́нин	курча́нка	курча́нцы
Ку́рскщина	ку́рскщинец	ку́рскщинка	ку́рскщинцы
Кызы́л	кызылча́нин	кызылча́нка	кызылча́не
Ла́нсинг 	ла́нсингец	ла́нсингка	ла́нсингцы
Лао́с	лао́сец	лао́ска	лао́сцы
Ла́твия	латви́ец	латви́йка	латви́йцы
Лати́нская Аме́рика	латиноамерика́нец	латиноамерика́нка	латиноамерика́нцы
Ленингра́дская о́бласть	ленингра́дец	ленингра́дка	ленингра́дцы
Лесо́то	лесо́тец	лесо́тка	лесо́тцы
Либе́рия	либери́ец	либери́йка	либери́йцы
Либреви́ль	либреви́лец	либреви́лька	либреви́льцы
Лива́н	лива́нец	лива́нка	лива́нцы
Ли́вия	ливи́ец	ливи́йка	ливи́йцы
Лило́нгве	лило́нгвец	лило́нгвка	лило́нгвцы
Ли́ма	ли́маец	ли́майка	ли́майцы
Ли́нкольн 	ли́нкольнец	ли́нкольнша	ли́нкольнцы
Ли́пецк	липецча́нец	липецча́нка	липецча́не
Лиссабо́н	лиссабо́нец	лиссабо́нка	лиссабо́нцы
Литва́	лито́вец	лито́вка	лито́вцы
Литл-Рок	литлро́кер	литлро́керша	литлро́кцы
Лихтенште́йн	лихтенште́йнец	лихтенште́йнка	лихтенште́йнцы
ЛНР	элэнэ́ровец	элэнэ́ровка	элэнэ́ровцы
Ломе́	ломе́ец	ломе́йка	ломе́йцы
Ло́ндон	ло́ндонец	ло́ндонка	ло́ндонцы
Лос-А́нджелес 	лоса́нджелец	лоса́нджелка	лоса́нджельцы
Луа́нда	луа́ндец	луа́ндка	луа́ндцы
Луга́нск	луга́нец	луга́нка	луган́цы
Луга́нская Наро́дная Респу́блика	луганча́нин	луганча́нка	луганча́не
Луизиа́на	луизиа́нец	луизиа́нка	луизиа́нцы
Луса́ка	луса́кец	луса́кка	луса́кцы
Лю́бляна	лю́блянец	лю́блянка	лю́блянцы
Люксембу́рг	люксембу́ржец	люксембу́рженка	люксембу́ржцы
Люксембу́рг	луксембу́ржец	люксембу́рженка	люксембу́ргцы / люксембу́ржцы
Маври́кий	маврики́ец	маврики́йка	маврики́йцы
Маврита́ния	маврита́нец	маврита́нка	маврита́нцы
Магада́н	мгада́нец	магада́нка	магада́нцы
Магада́н	магада́новец	магада́новка	магада́новцы
Мага́с	мага́сец	мага́ска	мага́сцы
Ма́гдебург	магдебу́ржец	магдебу́рженка	магдебу́ржцы
Ма́гдебург	магдебу́ржец	магдебу́ржка	магдебу́ргцы
Мадагаска́р	мадагаска́рец	мадагаска́рка	мадагаска́рцы
Мадагаска́р	малагасиец	малагасийка	малагасийцы
Ма́джуро	ма́джурец	ма́нджурка	ма́джурцы
Ма́дисон 	ма́дисонец	ма́дисонка	ма́дисонцы
Мадри́д	мадри́дец	мадри́дка	мадри́дцы
Майко́п	майко́пец	майко́пка	майко́пцы
Майнц	ма́йнец	ма́йнцка	ма́йнцы
Мака́о	мака́онец	мака́онка	мака́онцы
Македо́ния	македо́нец	македо́нка	македо́нцы
Мала́бо	мала́бец	мала́бка	мала́бцы
Мала́ви	малави́ец	малави́йка	малави́йцы
Мала́йзия	малайзи́ец	малайзи́йка	малайзи́йцы
Малая Азия	млази́ец	малази́йка	малази́йцы
Ма́ле	мале́ец	мале́йка	мале́йцы
Мали́	мали́ец	мали́йка	мали́йцы
Мальви́нские острова́	мальви́нец	мальви́нка	мальви́нцы
Мальди́вы	мальдивиа́нин	мальдивиа́нка	мальдивиа́не
Ма́льта	мальти́ец	мальти́йка	мальти́йцы
Мана́гуа	манагуа́нец	манагуа́нка	манагуа́нцы
Мана́ма	мана́мец	мана́мка	мана́мцы
Мани́ла	мани́лец	мани́лка	мани́льцы
Мапу́ту	мапу́туец	мапу́туйка	мапу́туйцы
Мари́й Эл	мари́ец	мари́йка	мари́йцы
Мари́й Эл	мариэ́ловец	мариэ́ловка	мариэ́ловцы
Маро́кко	марокка́нец	марокка́нка	марокка́нцы
Марша́лловы Острова́	марша́лловец	марша́лловка	марша́лловцы
Ма́серу	ма́нсеруец	ма́нсеруйка	ма́нсеруйцы
Маска́т	маска́тец	маска́тка	маска́тцы
Массачу́сетс	массачу́сетц	массачу́сетка	масачу́сетцы
Махачкала́	махачкали́нец	махачкали́нка	махачкали́нцы
Мбаба́не	мбаба́нец	мбаба́нка	мбаба́нцы
Ме́кленбург	ме́кленбургец	ме́кленбургка	ме́кленбургцы
Ме́кленбург	мѐкленбу́ржец	мѐкленбу́рженка	мѐкленбу́ржцы
Ме́ксика	мексика́нец	мексика́нка	мексика́нцы
Ме́хико	мехика́нец	мехика́нка	мехика́нцы
Микроне́зия	микронези́ец	микронези́йка	микронези́йцы
Миннесо́та	миннисо́тец	миннисо́тка	миннисо́тцы
Минск	минча́нин	минча́нка	минча́не
Миссиси́пи	миссиси́пец	миссиси́пка	миссиси́пцы
Миссу́ри	миссу́ринец	миссу́ринка	миссу́ринцы
Мичига́н	мичига́нец	мичига́нка	мичига́нцы
Могади́шо	могади́шец	могади́шка	могади́шцы
Мозамби́к	мозамби́кец	мозамби́йка	мозамби́кцы
Молда́вия	молдава́нин	молдава́нка	молдава́не
Мона́ко	монега́ск	монега́ска	монега́ски
Мона́ко	мона́ковец	мона́ковка	мона́кцы
Монго́лия	монго́л	монго́лка	монго́лы
Монро́вия	монро́вец	монро́вка	монро́вцы
Монта́на	монта́навец	монта́навка	монта́навцы
Монтго́мери 	монтго́мерец	монтго́мерша	монтго́мерцы
Монтевиде́о	монтевиде́овец	монтевиде́овка	монтевиде́овцы
Монтпи́лиер 	монтпилие́рец	монтпилие́рка	монтпилие́рцы
Мордо́вия	мордо́вец	мордо́вка	мордо́вцы / мордва́
Моро́ни	маро́ниец	маро́нийка	маро́нцы
Москва́	москви́ч	москви́чка	москвичи́
Моско́вия	моско́вец	моско́вка	моско́вцы
Музаффараба́д	музаффараба́дец	музаффараба́дка	музаффараба́дцы
Му́рманск	му́рманец	му́рманка	му́рманцы
Му́рманск	мурманча́нец	мурманча́нка	мурманча́нцы
Мья́нма	мья́нмец	мья́нмка	мья́нмцы
Мэн	мэ́нец	мэ́нка	мэ́нцы
Мэ́риленд	мэрилэ́ндец	мэрилэ́ндка	мэрилэ́ндцы
Мю́нхен	мю́нхенец	мю́нхенка	мю́нхенцы
Наго́рно-Караба́хская Респу́блика	нагоргокараба́ховец	нагоргокараба́ховка	нагоргокараба́ховцы
Найро́би	найро́биец	найро́бийка	найро́бцы
На́льчик	на́льчинец	на́льчинка	на́льчинцы
Нами́бия	намиби́ец	намиби́йка	намиби́йцы
Наньян-Ма́р	наньянма́рец	наньянма́рка	наньянма́рцы
Насса́у	насса́увец	насса́увка	насса́увцы
Науру́	науруа́нец	науруа́нка	науруа́нцы
На́швилл 	на́швиллец	на́швиллка	на́швилльцы
Нге́рулмуд	нгерулму́дец	нгерулму́дка	нгерулму́дцы
Нджаме́на	нджаме́нец	нджаме́нка	нджаме́нцы
Небра́ска	небра́скавец	небра́скавка	небра́скавцы
Нева́да	нева́давец	нева́давка	нева́давцы
Нейпьидо́	нейпьидо́ец	нейпьидо́йка	нейпьидо́йцы
Не́нецкий о́круг	не́нец	не́нка	не́нцы
Непа́л	непа́лец	непа́лка	непа́льцы
Ниаме́й	ниаме́йец	ниаме́йка	ниаме́йцы
Ниге́р	ниге́рец	ниге́рка	ниге́рцы
Ниге́рия	нигери́ец	нигери́йка	нигери́йцы
Нидерла́нды	нидерла́ндец	нидерла́ндка	нидерла́ндцы
Нижегоро́дщина	нижегоро́дщинец	нижегоро́дщинка	нижегоро́дщинцы
Ни́жний Но́вгород	нижегоро́дец	нижегоро́дка	нижегоро́дцы
Ни́жняя Саксо́ния	нижнесаксо́нец	нижнесаксо́нка	нижнесаксо́нцы
Никара́гуа	никарагуа́нец	никарагуа́нка	никарагуа́нцы
Никоси́я	никоси́ец	никоси́йка	никоси́йцы
Но́вая Зела́ндия	новозела́ндец	новозела́ндка	новозела́ндцы
Но́вгород	но́вгоро́дец	но́вгоро́дка	но́вгоро́дцы
Новгоро́дщина	новгоро́дщинец	новгоро́дщинка	новгоро́дщинцы
Новосиби́рск	новосиби́рец	новосиби́рка	новосиби́рцы
Норве́гия	норве́жец	норве́жка	норве́жцы
Но́рфолк	но́рфолковец	но́рфолковка	но́рфолковцы
Нуакшо́т	нуакшо́тец	нуакшо́тка	нуакшо́тцы
Нукуало́фа	нукуало́фец	нукуало́фка	нукуало́фцы
Нур-Султа́н	нурсулта́новец	нурсулта́новка	нурсулта́новцы
Нью-Гэ́мпшир	ньюгэ́мширец	ньюгэ́мширка	ньюгэ́мширцы
Нью-Де́ли	ньюдели́ец	ньюдели́цка	ньюдели́йцы
Нью-Дже́рси	ньюджерси́ец	ньюджерси́йка	ньюджерси́йцы
Нью-Йорк	ньюйо́ркер	ньюйо́керша	ньюйо́ркцы
Нью-Йо́рк 	ньюйо́ркер	ньюйо́ркша	ньюйо́ркцы
Нью-Ме́ксико	ньюмексика́нец	ньюмексика́нка	ньюмексика́нцы
Ога́йо	ога́йец	ога́йка	ога́йцы
Ога́ста 	ога́стец	ога́стка	ога́стцы
Оклахо́ма	оклахо́мец	оклахо́мка	оклахо́мцы
Оклахо́ма-Си́ти 	оклахо́мец	оклахо́мка	оклахо́мцы
Оли́мпия 	оли́мпиец	оли́мпийка	оли́мпийцы
Ома́н	ома́нец	ома́нка	ома́нцы
Омск	оми́ч	оми́чка	омичи́
Омск	омча́нец	омча́нка	омча́не
О́мщина	о́мщинец	о́мщинка	о́мщинцы
Орего́н	ориго́нец	ориго́нка	ориго́нцы
Орёл	орло́вец	орло́вка	орло́вцы
Оренбу́рг	оренбу́ржец	оренбу́рженка	оренбу́ргцы
Оренбу́ржщина	оренбу́ржщинец	оренбу́ржщинка	оренбу́ржщинцы
Оренбу́ржье	оренбу́ржец	оренбу́рженка	оренбу́ржцы
Орло́вщина	орло́вщинец	орло́вщинка	орло́вщинцы
О́сло	о́словец	о́словка	о́словцы
О́стин 	о́стинец	о́стинка	о́стинцы
О́стров Мэн	мэна́йлендец	мэна́йлендка	мэна́йлендцы
О́стров Но́рфолк / Норфолк-Айленд	но́рфолка́йлендец	но́рфолка́йлендка	но́рфолка́йлендцы
О́стров Рождества́ / Кри́стмас-А́йленд	кри́стмаса́йлендец	кри́стмаса́йлендка	кри́стмаса́йлендцы
островно́е госуда́рство	островитя́нин	островитя́нка	островитя́не
Отта́ва	отта́вец	отта́вка	отта́вцы
Пакиста́н	пакиста́нец	пакиста́нка	пакиста́нцы
Пала́у	палауа́нец	палауа́нка	палауа́нцы
Палести́на	палести́нец	палести́нка	палести́нцы
Палики́р	палики́рец	палики́рка	палики́рцы
Пана́ма	пана́мец	пана́мка	пана́мцы
Пана́ма	пана́мка	пана́мцы	пана́мцы
Пангея	пангеец	пангейка	пангейцы
Па́пуа — Но́вая Гвине́я	гвине́ец	гвине́йка	гвине́йцы
Па́пуа — Но́вая Гвине́я	папуа́с	папуа́ска	папуа́сы
Парагва́й	парагва́ец	парагва́йка	парагва́йцы
Парамари́бо	парамари́бец	парамари́бка	парамари́бцы
Пари́ж	парижа́нец	парижа́нка	парижа́не
Пеки́н	пеки́нец	пеки́нка	пеки́нцы
Пе́нза	пе́рзенец / пензя́к	пе́нзенка / пензя́чка	пе́нзенцы / пензяки́
Пе́нзенщина	пе́нзенщинец	пе́нзенщинка	пе́нзенщинцы
Пенсильва́ния	пенсильва́нец	пенсильва́нка	пенсильва́нцы
Пере́дняя Помера́ния	перѐднепомера́нец	перѐднепомера́нка	перѐднепомера́нцы
Пе́рмщина	пе́рмщинец	пе́рмщинка	пе́рмщинцы
Пермь	пермя́к	пермя́чка	пермяки́
Перу́	перуа́нец	перуа́нка	перуа́нцы
Петрозаво́дск	петрозаво́дец	петрозаво́дка	петразаво́дцы
Петропа́вловск-Камча́тский	петропа́вловсккамча́тец	петропа́вловсккамча́тка	петропа́вловсккамча́тцы
Пирр 	пи́ррец	пи́ррка	пи́ррцы
Пномпе́нь	пномпе́нец	пномпе́нька	пномпе́ньцы
Подго́рица	подго́рец	подго́рица	подго́рцы
По́льша	поля́к	по́лька / поля́чка	поля́ки
Помера́ния	помера́нец	помера́нка	помера́нцы
Помо́рье	помо́рец	помо́рица	помо́рцы
Помо́рье	помо́р	помо́рка	помо́ры
Порт-Ви́ла	портви́лец	портви́лка	портви́льцы
Порт-Луи́	портлу́ец	портлу́йка	портлу́йцы
Порт-Мо́рсби	портмо́рсбиец	портмо́рсбийка	портмо́рсбцы
Порт-о-Пренс	портопре́нсец	портопре́нска	портопре́нсцы
Порт-оф-Спейн	портофсте́йнец	портофсте́йнка	портофсте́йнцы
По́рто-Но́во	портоно́вец	портоно́вка	портоно́вцы
Португа́лия	португа́лец	португа́лка	португа́льцы
Потсда́м	потсда́мец	потсда́мка	потсда́мцы
Пра́га	пра́жец	пра́жка	пра́жцы
Пра́я	пра́йец	пра́йка	пра́йцы
Прето́рия	прето́рец	прето́рка	прето́рцы
Приво́лжье	приво́лжец	приво́лженка	приво́лжцы
Приднестро́вье	преднистро́вец	преднистро́вка	преднистро́вцы
Примо́рский край	приморча́нец	приморча́нка	приморча́не
Примо́рье	примо́рец	примо́рка	примо́рцы
При́штина	при́штинец	при́штинка	при́штинцы
Про́виденс 	про́виденсец	про́виденска	про́виденсцы
Псков	пско́вец	пско́вка	пско́вцы
Пско́вщина	пско́вщинец	пско́вщинка	пско́вщинцы
Пуэ́рто-Ри́ко 	пуэрторика́нец	пуэрторика́нка	пуэрторика́нцы
Пхенья́н	пхенья́нец	пхенья́нка	пхенья́нцы
Пятиго́рск	пятиго́рец	пятиго́рка	пятиго́рцы
Раба́т	раба́тец	раба́тка	раба́тцы
Ра́малла	рама́лец	рама́лка	рама́льцы
Рейкья́вик	рейкья́вец	рейкья́вка	рейкья́вцы
Ре́йнланд-Пфальц	пфа́лец	пфа́льцка	пфа́льцы
Ри́га	рижа́нец	рижа́нка	рижа́не
Рим	ри́млянин	ри́млянка	ри́мляне
Ри́чмонд 	ри́чмондец	ри́чмондка	ри́чмондцы
Род-А́йленд	рода́лендец	рода́лендка	рода́лендцы
Розо́	розо́вец	розо́вка	розо́вцы
Ро́ли 	ро́лиец	ро́лийка	ро́лийцы
Росси́я	россия́нин	россия́нка	россия́не
Росто́в-на-Дону́	ростовча́нин	ростовча́нка	ростовча́не
Росто́вщина	росто́вщинец	росто́вщинка	росто́вщинцы
Руа́нда	руанди́ец	руанди́йка	руанди́йцы
Румы́ния	румы́н	румы́нка	румы́ны
Ряза́нщина	ряза́нщинец	ряза́нщинка	ряза́нщинцы
Ряза́нь	ряза́нец	ряза́нка	ряза́нцы
Саа́р	саа́рец	саа́рка	саа́рцы
Саарбрю́ккен	саарбрю́ккенец	саарбрю́ккенка	саарбрю́ккенцы
Саксо́ния	саксо́нец	саксо́нка	сакс́онцы
Саксо́ния-А́нхальт	саксо́на́нхалец	саксо́на́нхалька	саксо́на́нхальцы
Салеха́рд	салеха́рдец	салеха́рдка	салеха́рдцы
Сальвадо́р	сальвадо́рец	сальвадо́рка	сальвадо́рцы
Сама́ра	сама́рец	сама́рка	сама́рцы
Сама́рщина	сама́рщинец	сама́рщинка	сама́рщинцы
Само́а	самоа́нец	самоа́нка	самоа́нцы
Сан-Мари́но	санмари́нец	санмари́нка	санмари́нцы
Сан-Сальвадо́р	сансальвадо́рец	сансальвадо́рка	сансальвадо́рцы
Сан-Томе́	сантоме́ец	сантоме́йка	сантоме́йцы
Сан-Томе́ и При́нсипи	сантоми́ец	сантоми́йка	сантоми́йцы
Сан-Хосе́	санхосе́нец	санхосе́нка	санхосе́нцы
Сан-Хуа́н	санхуа́нцы	санхуа́нец	санхуа́нка
Са́на́	са́на́ец	са́на́йка	са́на́йцы
Санкт-Петербу́рг	санктпетербу́ржец	санктпетербу́рженка	санктпетербу́ржцы
Са́нта-Фе 	са́нтафе́ец	са́нтафе́йка	са́нтафе́йцы
Са́нто-Доми́нго	сантадоми́нговец	сантадоми́нговка	сантадоми́нговцы
Сантья́го	сантья́говец	сантья́говка	сантья́говцы
Сара́ево	сара́евец	сара́евка	сара́евцы
Сара́нск	сара́нец	сара́нка	сара́нцы
Сара́тов	сара́товец	сара́товка	сара́товцы
Сара́товщина	сара́товщинец	сара́товщинка	сара́товщинцы
Сау́довская Ара́вия	сауди́т	сауди́тка	сауди́ты
Саха́	саха́ей	саха́йка	саха́йцы
Сахали́нская о́бласть	сахали́нец	сахали́нка	сахали́нцы
Саха́ра САДР	саха́рец	саха́рка	саха́рцы
Сва́зиле́нд	сва́зиле́ндец	сва́зиле́ндка	сва́зиле́ндцы
Свердло́вская о́бласть	свердловча́нин	свердловча́нка	свердловча́не
Свердло́вщина	свердло́вщинец	свердло́вщинка	свердло́вщинцы
Се́верная Аме́рика	сѐвероамерика́нец	сѐвероамерика́нка	сѐвероамерика́нцы
Се́верная Дако́та	северодако́тинец	северодако́тинка	северодако́тинцы
Се́верная Евро́па	сѐвероевропе́ец	сѐвероевропе́йка	сѐвероевропе́йцы
Се́верная Кароли́на	северокароли́нец	северокароли́нка	северокароли́нцы
Се́верная Македо́ния	северомакедо́нец	северомакедо́нка	северомакедо́нцы
Се́верная Осе́тия — Ала́ния	североосетинец / североосетин	североосети́нка	североосети́нцы / североосети́ны
Се́верный Ки́пр	северокиприо́т / киприо́т	северокиприо́тка / киприо́тка	северокиприо́ты / киприо́ты
Се́верный Рейн — Вестфа́лия	ре́йнец / вестфа́лец	ре́йнка / вестфа́лька	ре́йнцы / вестфа́льцы
Се́веро-Кавка́зский о́круг	северокавка́зец	северокавка́зка	северокавка́зцы
Се́вероза́падная часть контине́нта	севреноза́падный европе́ец	северноза́падная европе́йка	североза́падные европе́йцы
Се́йлем 	се́йлемец	се́йлемка	се́йлемцы
Сейше́льские Острова́ Сейше́лы	сейше́лец	сейше́лка	сейше́льцы
Сенега́л	сенега́лец	сенега́лка	сенега́льцы
Сент-Ви́нсент и Гренади́ны	сентвинсе́нтец	сентвинсе́нтка	сентвинсе́нтцы
Сент-Джонс	сентджо́нсец	сентджо́нсенка	сентджо́нсцы
Сент-Джо́рджес	сентджо́рджесец	сентджо́рджеска	сентджо́рджесцы
Сент-Ки́тс и Не́вис	сентки́тсец	сентки́тска	сентки́тсцы
Сент-Люси́я	сентлюси́ец	сентлюси́йка	сентлюси́йцы
Сент-Пи́тер-Порт	сентпитерпо́ртец	сентпитерпо́ртка	сентпитерпо́ртцы
Сент-Пол 	сентпо́лец	сентпо́лька	сентпо́льцы
Сент-Хе́лиер	сентхелье́рец	сентхелье́рка	сентхелье́рцы
Се́рбия	серб	се́рбка	се́рбы
Се́ттлмент	се́ттлментец	се́ттлментка	се́ттлментцы
Сеу́л	сеу́лец	сеу́лка	сеу́льцы
Сиби́рский о́круг	сибиря́к	сибиря́чка	сибиряки́
Симферо́поль	симферо́полец	симферо́полька	симферо́польцы
Сингапу́р	сингапу́рец	сингапу́рка	сингапу́рцы
Си́рия	сири́ец	сири́йка	сири́йцы
Ско́пье	ско́пьец	ско́пьецка	ско́пьецы
Слова́кия	слова́к	слова́чка	слова́ки
Слове́ния	слове́нец	слове́нка	слове́нцы
Смоле́нск	смоля́нец	смоля́нка	смоля́не
Смоле́нщина	смоле́нщинец	смоле́нщинка	смоле́нщинцы
Соломо́новы Острова́	соломо́новец	соломо́новка	соломо́новцы
Солт-Лейк-Си́ти 	солтле́йкер	солте́йкерша	солтле́йкерцы
Сомали́	сомали́ец	сомали́йка	сомали́йцы
Сомалиле́нд	сомалиле́ндец	сомалиле́ндка	сомалиле́ндцы
Софи́я	софи́ец	софи́йка	софи́йцы
Ста́врополь	ста́врополец	ста́врополька	ставропо́льцы
Ставропо́лье	ставропо́лец	ставропо́лька	ставропо́льцы
Степанаке́рт	степанаке́ртец	степанаке́ртцы	степанаке́ртцы
Стокго́льм	стокго́льмец	стокго́льмка	стокго́льмцы
Стэ́нли	стэ́нлиец	стэ́нлийка	стэ́нлийцы
Су́ва	су́вец	су́вка	су́вцы
Суда́н	суда́нец	суда́нка	суда́нцы
Су́кре	су́креец	су́крейка	су́крейцы
Сурина́м	сурина́мец	сурина́мка	сурина́мцы
Суху́м	суху́мец	суху́мка	суху́мцы
США	америка́нец	америка́нка	америка́нцы
Сыктывка́р	сыктывка́рец	сыктывка́рка	сыктывка́рцы
Сье́рра-Лео́не	сьерралео́нец	сьерралео́нка	сьерралео́нцы
Таджикиста́н	таджи́к / такджикиста́нец	таджи́чка / таджикиста́нка	таджи́ки / таджикиста́нцы
Таила́нд	таила́ндец	таила́ндка	таила́ндцы
Тайбэ́й	тайбэ́йец	тайбэ́йка	тайбэ́йцы
Тайва́нь	тайва́нец	тайва́нка	тайва́нцы
Таллаха́сси 	таллаха́ссец	таллаха́сска	таллаха́ссцы
Та́ллин	та́ллинец	та́ллинка	та́ллинцы
Тамбо́в	тамбо́вец	тамбо́вка	тамбо́вцы
Тамбо́вщина	тамбо́вщинец	тамбо́вщинка	тамбо́вщинцы
Танза́ния	танзани́ец	танзани́йка	танзани́йцы
Татарста́н	татарста́нец / тата́рин	татарста́нка / тата́рка	татарста́нцы / тата́ры
Ташке́нт	ташке́нтец	ташке́нтка	ташке́нтцы
Тбили́си	тбили́сец	тбили́ска	тбили́сцы
Тверь	тве́рец	тве́рка	тве́рцы
Тегера́н	тегера́нец	тегера́нка	тегера́нцы
Тегусига́льпа	тегусига́льпец	тегусига́льпка	тегусига́льпцы
Те́ннесси	теннеси́ец	теннеси́йка	теннеси́йцы
Теха́с	теха́сец	теха́ска	теха́сцы
Тимо́р	тимо́рец	тимо́рка	тимо́рцы
Тира́на	тира́нец	тира́нка	тира́нцы
Тира́споль	тира́сполец	тира́сполька	тира́спольцы
Тифа́рити	тифа́ритиец	тифа́ритийка	тифа́ритийцы
То́го	тоголе́зец	тоголе́зка	тоголе́зцы
То́кио	токи́йец	токи́йка	токи́йцы
Томск	томи́ч	томича́нка	томичи́
То́мщина	то́мщинец	то́мщинка	то́мщинцы
То́нга	то́нганец	то́нганка	то́нганцы
Топи́ка 	топика́ец	топика́йка	топи́кцы
Тре́нтон 	тре́нтонец	тре́нтонша	тре́нтонцы
Тринида́д и Тоба́го	тринида́дец	тринида́дка	тринида́дцы
Три́поли	три́полец	три́полька	три́польцы
Тува́лу	тували́ец	туваля́нка	тували́йцы
Ту́ла	туля́к	туля́чка	туляки́
Ту́льщина	ту́льщинец	ту́льщинка	ту́льщинцы
Туни́с	туни́сец	туни́ска	туни́сцы
Туркмениста́н	туркмениста́нец	туркмениста́нка	туркмениста́нцы
Туркме́ния	туркме́н	туркме́нка	туркмены
Ту́рция	ту́рок	турча́нка	ту́рки
Тхимпху́	тхимпху́ец	пхимпху́йка	тхимпху́йцы
Тыва́	тува́нец	туви́нка	тувин́цы
Тюме́нь	тюме́нец	тюме́нка	тбме́нцы
Тюме́нь	тюменьча́нин	тюменьча́нка	тюменьча́не
Тюме́ньщина	тюме́ньщинец	тюме́ньщинка	тюме́ньщинцы
Тюри́нгия	тюри́нгец	тури́нгка	тюри́нгцы
Уагаду́гу	уганду́гец	уганду́гка	уганду́гцы
Уга́нда	уганди́ец	уганди́йка	уганди́йцы
Удму́ртия	удму́рт	удму́ртка	удму́рты
Узбекиста́н	узбе́к / узбекиста́нец	узбе́чка / узбекиста́нка	узбе́ки / узбекиста́нцы
Украи́на	украи́нец	украи́нка	украи́нцы
Ула́н-Ба́тор	уланба́торец	уланба́торка	уланба́торцы
Ула́н-Уде́	улануди́нец	улауди́нка	улануди́нцы
Улья́новск	улья́новец	улья́новка	улья́новцы
Улья́новщина	улья́новщинец	улья́новщинка	улья́новщинцы
Ура́л	ура́лец	ура́лка	ура́льцы
Уругва́й	уругва́ец	уругва́йка	уругва́йцы
Уфа́	уфи́мец	уфи́мка	уфи́мцы
Фи́джи	фиджи́ец	фиджи́йка	фиджи́йцы
Филиппи́ны	филиппи́нец	филиппи́нка	филиппи́нцы
Фи́никс 	фи́никсец	фи́никсша	фи́никсцы
Финля́ндия	финн	фи́ннка / фи́нка	фи́нны
Фла́йинг-Фиш-Ков	фла́йингфишковец	фла́йингфишковка	фла́йингфишковцы
Флори́да	флори́дец	флори́дка	флори́дцы
Фолкле́нды	фонкле́ндец	фонкле́ндка	фонкле́ндцы
Фра́нкфорт 	фра́нкфортец	фра́нкфортка	фра́нкфортцы
Фра́нция	францу́з	францу́женка	францу́зы
ФРГ	ФРГшник фээргэ́шник	ФРГшница фээргэ́шница	ФРГшники фээргэ́шники
Фри́таун	фрита́унец	фрита́унка	фрита́унцы
Фунафу́ти	фунафу́тец	фунафу́тка	фунафу́тцы
Хаба́ровск	хаба́ровец	хаба́ровка	хаба́ровцы
Хаба́ровский край	хаба́ровец	хаба́ровка	хаба́ровцы
Хака́сия	хака́с	хака́ска	хака́сы
Хано́й	хано́ец	хано́йка	хано́йцы
Ха́нты-Манси́йск	хантыманси́ец	хантыманси́йка	хантыманси́йцы
Хара́ре	хара́рец	хара́рка	хара́рцы
Харге́йса	харге́йсец	харге́йска	харге́йсцы
Харту́м	харту́мец	харту́мка	харту́мцы
Ха́ртфорд 	ха́ртфордец	ха́рфордка	ха́ртфордцы
Хе́лена 	хе́ленец	хе́ленка	хе́ленцы
Хе́льсинки	хе́льсинец	хе́льсинка	хе́льсинкцы
Хониа́ра	хониа́рец	хониа́рка	хониа́рцы
Хорва́тия	хорва́т	хорва́тка	хорва́ты
ЦАР	ца́ровец	ца́ровка	ца́ровцы
Центральноафрика́нская Респу́блика	центральноафрика́нец	центральноафрика́нка	центральноафрика́нцы
Центра́льноевропе́йский контине́нт	центральноевропе́ец	центральноевропе́йка	центральноевропе́йцы
Цхинва́л	цхинва́лец	цхинва́лка	цхинва́льцы
Чад	ча́дец	ча́дка	ча́дцы
Ча́рлстон 	ча́рлстонец	ча́рлстонка	ча́рлстонцы
Чебокса́ры	чебокса́рец	чебокса́рка	чебокса́рцы
Челя́бинск	челя́бинец	челя́бинка	челя́бинцы
Челя́бинщина	челя́бинщинец	челя́бинщинка	челя́бинщинцы
Черке́сск	черке́ссец	черке́сска	черке́ссцы
Черного́рия	черного́рец	черного́рка	черного́рцы
Че́хия	чех	че́шка	че́хи
Чечня́	чече́нец	чече́нка	чече́нцы
Чика́го 	чика́говец	чика́говка	чика́говцы / чикагцы
Чи́ли	чили́ец	чили́йка	чили́йцы
Чита́	чити́нец	чити́нка	чити́нцы
Чува́шия	чува́ш	чува́шка / чува́шинка	чуваши́
Чуко́тский о́круг	чу́кча	чукча́нка	чу́кчи
Шайе́нн 	шайе́ннец	шайе́ннка	шайе́ннцы
Швейца́рия	швейца́рец	швейца́рка	швейца́рцы
Швери́н	шве́ринец	шве́ринка	шве́ринцы
Шве́ция	швед	шве́дка	шве́ды
Шле́звиг-Гольште́йн	шле́звиггольште́йнец	шле́звиггольште́йнка	шле́звиггольште́йнцы
Шри-Джаява́рденепура-Ко́тте	ко́ттец	ко́ттка	ко́ттцы
Шри-Джаява́рденепура-Ко́тте	шриджаяварденепурако́ттец	шриджаяварденепурако́ттка	шриджаяварденепурако́ттцы
Шри-Ла́нка	шриланки́ец	шриланки́йка	шриланки́йцы
Шту́тгарт	шту́тгартец	шту́тгартка	шту́тгартцы
Эквадо́р	эквадо́рец	эквадо́рка	эквадо́рцы
Экваториа́льная Гвине́я	экваторогвине́ец	экваторогвине́йка	экваторогвине́йцы
Элиста́	элисти́нец	элисти́нка	элисти́нцы
Эль-Куве́йт	куве́йтец	куве́йтка	куве́йтцы
Эр-Рия́д	эррия́дец	эррия́дка	эррия́дцы
Эритре́я	эритре́ец	эритре́йка	эритре́йцы
Э́рфурт	э́рфуртец	э́рфуртка	э́рфуртцы
Эсвати́ни	эсвати́нец	эсвати́нка	эсвати́нцы
Эсто́ния	эсто́нец	эсто́нка	эсто́нцы
Эфио́пия	эфио́п	эфио́пка	эфио́пы
ЮАР	юа́ровец	юа́ровка	юа́рцы
Югоза́падная Евро́па	югоза̀падноевропе́ец	югоза̀падноевропе́йка	югоза̀падноевропе́йцы
Югра́	югра́нец	югра́нка	югра́не
Ю́жная Гео́ргия	ю̀гогео́ргиец	ю̀гогео́ргийка	ю̀гогео́ргийцы
Ю́жная Дако́та	южнодако́товец	южнодако́товка	южнодако́товцы
Ю́жная Кароли́на	южнокароли́нец	южнокароли́нка	южнокароли́нцы
Ю́жная Коре́я	южнокоре́ец	южнокорея́нка	южнокоре́йцы
Ю́жная О́сетия	югоосети́н	югоосети́нка	югоосети́ны
Ю́жная Тара́ва (Баири́ки)	тараване́ц	тарава́нка	тарава́нцы
Ю́жно-Африка́нская Респу́блика	южноафрика́нец	южноафрика́нка	южноафрика́нцы
Ю́жно-Сахали́нск	южносахали́нец	южносахали́нка	южносахали́нцы
Южноевропе́йкий контине́нт	ю́жный европе́ец	ю́жная европе́йка	ю́жные европе́йцы
Ю́жный Суда́н	южносуда́нец	южносуда́нка	южносуда́нцы
Ю́та	ю́танец	ю́танка	ю́танцы
Яку́тия	яку́т	яку́тка	яку́ты
Яку́тск	яку́т	яку́тка	якутя́не
Яма́йка	яма́ец	яма́йка	яма́йцы
Яма́ло-Не́нецкий о́круг	яма́лоне́нец	яма́лоне́нка	яма́лоне́нцы
Яма́ло-Не́нецкий о́круг	не́нец	не́нка	не́нцы
Ямусу́кро	ямусу́кровец	ммусу́кровка	ямусу́кровцы
Япо́ния	япо́нец	япо́нка	япо́нцы
Яросла́вль	яросла́влец	яросла́влевка	яросла́влевцы
Яросла́вская о́бласть	яросла́вец	яросла́вка	яросла́вцы
Яросла́вщина	яросла́вщинец	яросла́вщинка	яросла́вщинцы
Я́унде	я́ундец	я́ундка	я́ундцы
